....................
....................
....................
....................
....................
....................
....................
....................
....................
....................
....................
....................
....................
.1................2.
####################
